****************
*XXXXXXXXXXXXXE*
*X             *
*X             *
*X             *
*X             *
*S             *
****************
